+-------------+
|  -------    |
|- ---     - -|
|- -    ------|
|  - -- - - - |
|-   -- - - - |
|-- ----- - - |
|--       -   |
|-------- - - |
|   -   - - - |
| - - - -   - |
| --- - --- --|
| --- -       |
|     -- ----$O
+-------------+