wwswwwwwwwwwwww
ww0wwwwwww0000w
ww0www00000w0ww
ww0w0000wwwwwww
w00w0ww0w0w0w0w
ww000ww0w0w0w0w
www0wwwww0w0w0w
www0000000w000w
wwwwwwwww0w0w0w
w000w000w0w0w0w
w0w0w0w0w000w0w
w0www0w0www0www
w0www0w0000000w
w00000ww0wwww0w
wwwwwwwwwwwwwfw

